...##..##...........
...##...............
...##.~##...########
...##..##...........
...##~.##...........
...##..##...........
...##..####~~~......
....................
....................
....................
