.......####..~.~....
.......~~~~..~.~.~..
.......####..~.~.~..
...............~.~..
.......####......~..
.......####..####...
....................
....................
....................
.......####.........
