........~~~~........
........~~~~........
........~~~.........
........~~~.........
........~~..........
........~~..........
........~~..........
........~~..........
........~...........
....................
